1111111111111111111111111111111111
1000000000000000000000000000000001
10P1111111111000000000000000000001
1000000000000000000000000000000001
10000C0000111111111111111110000001
1000000000000000000000000000000001
1111111111100000000100000000000001
10000000000000000001000C0000000001
1000000000000000000100000000000E01
1000000000000000000100000000000001
1111111111111111111111111111111111
