1111111111111111111111111111111111111111111111
100000000000000000000C000000000000000011111111
110000000000C000000000000000000000111111111111
1110000000000000000000000000001111111111111111
1111100000000000001110000000000001111111100111
1100111000E0000C11111110000000C000001111000111
1110011100000000011111111000000000000110000001
111111000000001011100001000011100P000111100011
1111111111111111111111111111111111111111111111
