111111111111111111
1000000001000011111
1P0000000E000000011
111C000000000000000
1111111111111111111
