11111111
10000001
10000001
1000E001
1C000001
1PC00001
11111111
