11111111
10000001
10E0C001
1P000001
11111111
